■■■　　　　　　■
■■■　■■■■　■
開　　　　　　■　■
■■■■　■■■　■
■■■■　■■■　■
■■　　　■■■　■
■■　■　　　■　■
■■　■■■■■■■
■■　　　　　　　■
■■■■■■■■終■